n,scammer,conversation_days,number_of_conversations,outbounds,inbounds,strategy
1,scammer_1,0.04346064814814815,3, 2, 1,gpt-4-Chat1
2,scammer_3,0.00030092592592592595,3, 2, 1,gpt-4-Chat1
3,scammer_4,0.00034722222222222224,3, 2, 1,gpt-4-Chat1
4,scammer_6,0.0,2, 1, 1,gpt-4-Chat1
5,scammer_8,0.0,2, 1, 1,gpt-3.5-turbo-Chat2
6,scammer_9,0.12563657407407408,9, 7, 2,gpt-3.5-turbo-Chat2
7,scammer_10,0.13447916666666668,5, 3, 2,gpt-4-Chat1
8,scammer_11,0.06702546296296297,8, 5, 3,gpt-3.5-turbo-Chat2
9,scammer_13,0.002384259259259259,3, 2, 1,gpt-3.5-turbo-Chat2
10,scammer_16,0.014444444444444444,5, 3, 2,gpt-4-Chat1
11,scammer_21,1.7724768518518519,11, 7, 4,gpt-3.5-turbo-Chat2
12,scammer_24,0.22846064814814815,4, 2, 2,gpt-4-Chat1
13,scammer_28,0.7175578703703703,4, 2, 2,gpt-3.5-turbo-Chat2
14,scammer_29,0.0007638888888888889,3, 2, 1,gpt-4-Chat1
15,scammer_30,0.0042592592592592595,3, 2, 1,gpt-4-Chat1
16,scammer_31,0.8848495370370371,6, 4, 2,gpt-3.5-turbo-Chat2
17,scammer_32,0.0,2, 1, 1,gpt-4-Chat1
18,scammer_34,0.0,2, 1, 1,gpt-4-Chat1
19,scammer_35,2.0051041666666665,7, 4, 3,gpt-3.5-turbo-Chat2
20,scammer_38,15.080381944444444,82, 42, 40,gpt-3.5-turbo-Chat2
21,scammer_42,0.010416666666666666,3, 2, 1,gpt-4-Chat1
22,scammer_47,0.0,2, 1, 1,gpt-3.5-turbo-Chat2
23,scammer_55,0.030949074074074073,11, 6, 5,gpt-3.5-turbo-Chat2
24,scammer_59,0.2953587962962963,29, 16, 13,gpt-4-Chat1
25,scammer_61,0.0,2, 1, 1,gpt-3.5-turbo-Chat2
26,scammer_63,2.9384259259259258,4, 3, 1,gpt-4-Chat1
27,scammer_65,1.480775462962963,7, 3, 4,gpt-4-Chat1
28,scammer_69,6.0980439814814815,7, 4, 3,gpt-3.5-turbo-Chat2
29,scammer_70,1.8678703703703703,17, 15, 2,gpt-3.5-turbo-Chat2
30,scammer_73,5.5897800925925925,3, 2, 1,gpt-4-Chat1
31,scammer_74,0.8049189814814814,5, 3, 2,gpt-4-Chat1
32,scammer_75,1.0821412037037037,19, 10, 9,gpt-3.5-turbo-Chat2
33,scammer_78,5.793101851851852,25, 13, 12,gpt-4-Chat1
34,scammer_83,5.187997685185185,34, 19, 15,gpt-3.5-turbo-Chat2
35,scammer_84,0.01607638888888889,3, 2, 1,gpt-3.5-turbo-Chat2
36,scammer_85,0.0003356481481481481,3, 2, 1,gpt-3.5-turbo-Chat2
37,scammer_86,22.88533564814815,4, 3, 1,gpt-3.5-turbo-Chat2
38,scammer_87,0.0008333333333333334,4, 3, 1,gpt-4-Chat1
39,scammer_88,0.02516203703703704,9, 6, 3,gpt-3.5-turbo-Chat2
40,scammer_91,10.257141203703704,40, 21, 19,gpt-3.5-turbo-Chat2
41,scammer_92,4.293587962962963,3, 2, 1,gpt-4-Chat1
42,scammer_93,2.94375,4, 3, 1,gpt-3.5-turbo-Chat2
43,scammer_97,5.228356481481481,9, 6, 3,gpt-3.5-turbo-Chat2
44,scammer_100,7.101076388888889,18, 11, 7,gpt-4-Chat1
45,scammer_101,3.0609953703703705,21, 12, 9,gpt-4-Chat1
46,scammer_102,0.04857638888888889,15, 8, 7,gpt-4-Chat1
47,scammer_103,1.3375694444444444,3, 2, 1,gpt-3.5-turbo-Chat2
48,scammer_104,0.8218865740740741,31, 22, 9,gpt-4-Chat1
49,scammer_105,11.957696759259258,13, 7, 6,gpt-4-Chat1
50,scammer_107,0.002199074074074074,3, 1, 2,gpt-4-Chat1
51,scammer_111,3.963599537037037,12, 7, 5,gpt-3.5-turbo-Chat2
52,scammer_112,7.287407407407407,7, 5, 2,gpt-4-Chat1
53,scammer_114,0.05126157407407408,7, 4, 3,gpt-3.5-turbo-Chat2
54,scammer_115,5.636817129629629,6, 4, 2,gpt-3.5-turbo-Chat2
55,scammer_116,0.057951388888888886,18, 10, 8,gpt-4-Chat1
56,scammer_120,0.03869212962962963,3, 2, 1,gpt-3.5-turbo-Chat2
57,scammer_124,3.9891319444444444,30, 22, 8,gpt-4-Chat1
58,scammer_126,3.20787037037037,20, 11, 9,gpt-3.5-turbo-Chat2
59,scammer_128,5.670694444444444,17, 10, 7,gpt-3.5-turbo-Chat2
60,scammer_129,3.0861342592592593,15, 8, 7,gpt-3.5-turbo-Chat2
61,scammer_130,5.777673611111111,26, 15, 11,gpt-4-Chat1
62,scammer_131,2.688148148148148,7, 4, 3,gpt-3.5-turbo-Chat2
63,scammer_132,2.6246412037037037,10, 5, 5,gpt-4-Chat1
64,scammer_135,0.056122685185185185,3, 2, 1,gpt-4-Chat1
65,scammer_140,8.346354166666666,170, 85, 85,gpt-3.5-turbo-Chat2
66,scammer_142,2.0003356481481482,7, 4, 3,gpt-3.5-turbo-Chat2
67,scammer_143,0.04850694444444444,5, 3, 2,gpt-3.5-turbo-Chat2
68,scammer_145,0.292662037037037,5, 4, 1,gpt-3.5-turbo-Chat2
69,scammer_148,8.101851851851852e-05,3, 2, 1,gpt-3.5-turbo-Chat2
70,scammer_150,13.665671296296296,12, 9, 3,gpt-3.5-turbo-Chat2
71,scammer_160,0.00047453703703703704,3, 2, 1,gpt-4-Chat1
72,scammer_161,0.6803587962962963,14, 9, 5,gpt-3.5-turbo-Chat2
73,scammer_162,5.741238425925926,5, 3, 2,gpt-3.5-turbo-Chat2
74,scammer_163,0.04097222222222222,15, 9, 6,gpt-4-Chat1
75,scammer_164,11.563043981481481,57, 31, 26,gpt-3.5-turbo-Chat2
76,scammer_167,5.3546875,9, 5, 4,gpt-3.5-turbo-Chat2
77,scammer_168,27.58900462962963,7, 4, 3,gpt-3.5-turbo-Chat2
78,scammer_169,0.02189814814814815,4, 3, 1,gpt-4-Chat1
79,scammer_170,0.0,2, 1, 1,gpt-4-Chat1
80,scammer_177,5.564201388888889,13, 7, 6,gpt-3.5-turbo-Chat2
81,scammer_178,0.0,2, 1, 1,gpt-4-Chat1
82,scammer_183,0.05914351851851852,20, 11, 9,gpt-4-Chat1
83,scammer_188,7.103125,28, 17, 11,gpt-3.5-turbo-Chat2
84,scammer_190,5.834456018518519,42, 28, 14,gpt-4-Chat1
85,scammer_191,8.605543981481482,17, 11, 6,gpt-3.5-turbo-Chat2
86,scammer_194,1.395474537037037,10, 7, 3,gpt-4-Chat1
87,scammer_196,0.04542824074074074,5, 3, 2,gpt-4-Chat1
88,scammer_197,0.48515046296296294,8, 5, 3,gpt-4-Chat1
89,scammer_198,2.9657175925925925,16, 10, 6,gpt-3.5-turbo-Chat2
90,scammer_201,0.056122685185185185,12, 7, 5,gpt-4-Chat1
91,scammer_208,0.10155092592592592,5, 3, 2,gpt-4-Chat1
92,scammer_214,4.793784722222222,27, 17, 10,gpt-4-Chat1
93,scammer_219,0.009398148148148149,3, 2, 1,gpt-4-Chat1
94,scammer_223,6.850555555555555,25, 17, 8,gpt-4-Chat1
95,scammer_226,6.179351851851852,39, 20, 19,gpt-3.5-turbo-Chat2
96,scammer_233,0.0002777777777777778,3, 2, 1,gpt-3.5-turbo-Chat2
97,scammer_236,0.016064814814814816,3, 2, 1,gpt-3.5-turbo-Chat2
98,scammer_240,4.173634259259259,7, 4, 3,gpt-3.5-turbo-Chat2
99,scammer_241,0.1407986111111111,52, 28, 24,gpt-4-Chat1
100,scammer_247,0.6851736111111111,5, 3, 2,gpt-3.5-turbo-Chat2
101,scammer_249,0.6050231481481482,12, 6, 6,gpt-3.5-turbo-Chat2
102,scammer_250,0.06355324074074074,10, 6, 4,gpt-4-Chat1
103,scammer_253,0.8824421296296296,8, 5, 3,gpt-4-Chat1
104,scammer_254,0.2762384259259259,14, 8, 6,gpt-4-Chat1
105,scammer_257,10.560949074074074,20, 11, 9,gpt-4-Chat1
106,scammer_258,0.0005671296296296297,3, 2, 1,gpt-4-Chat1
107,scammer_259,5.049166666666666,7, 4, 3,gpt-4-Chat1
108,scammer_260,1.7616550925925927,13, 7, 6,gpt-4-Chat1
109,scammer_263,0.8667939814814815,7, 4, 3,gpt-4-Chat1
110,scammer_265,5.600532407407408,5, 3, 2,gpt-3.5-turbo-Chat2
111,scammer_268,0.13456018518518517,9, 5, 4,gpt-3.5-turbo-Chat2
112,scammer_270,0.04842592592592593,23, 12, 11,gpt-3.5-turbo-Chat2
113,scammer_271,4.305127314814815,92, 80, 12,gpt-4-Chat1
114,scammer_283,0.04170138888888889,4, 2, 2,gpt-3.5-turbo-Chat2
115,scammer_289,0.11135416666666667,3, 2, 1,gpt-4-Chat1
116,scammer_290,0.02861111111111111,3, 2, 1,gpt-3.5-turbo-Chat2
117,scammer_291,1.3458333333333334,4, 2, 2,gpt-4-Chat1
118,scammer_295,0.4773148148148148,5, 3, 2,gpt-4-Chat1
119,scammer_296,2.0102546296296295,14, 8, 6,gpt-3.5-turbo-Chat2
120,scammer_297,5.849375,15, 8, 7,gpt-4-Chat1
121,scammer_301,7.427789351851852,23, 15, 8,gpt-4-Chat1
122,scammer_303,1.5000694444444445,8, 4, 4,gpt-4-Chat1
123,scammer_305,0.0008217592592592593,3, 2, 1,gpt-3.5-turbo-Chat2
124,scammer_306,5.999988425925926,9, 5, 4,gpt-4-Chat1
125,scammer_307,4.729803240740741,22, 12, 10,gpt-4-Chat1
126,scammer_309,0.028819444444444446,10, 6, 4,gpt-4-Chat1
127,scammer_311,0.04662037037037037,5, 3, 2,gpt-4-Chat1
128,scammer_315,0.13277777777777777,4, 3, 1,gpt-4-Chat1
129,scammer_317,0.1,19, 10, 9,gpt-3.5-turbo-Chat2
130,scammer_318,5.403275462962963,3, 2, 1,gpt-3.5-turbo-Chat2
131,scammer_320,1.4980439814814814,6, 4, 2,gpt-3.5-turbo-Chat2
132,scammer_321,1.4995138888888888,67, 47, 20,gpt-3.5-turbo-Chat2
133,scammer_328,0.01392361111111111,3, 2, 1,gpt-3.5-turbo-Chat2
134,scammer_329,0.006701388888888889,3, 2, 1,gpt-3.5-turbo-Chat2
135,scammer_330,0.29160879629629627,6, 3, 3,gpt-3.5-turbo-Chat2
136,scammer_332,0.7731712962962963,43, 33, 10,gpt-4-Chat1
137,scammer_333,4.817476851851852,17, 9, 8,gpt-4-Chat1
138,scammer_335,1.4236342592592592,3, 2, 1,gpt-3.5-turbo-Chat2
139,scammer_341,2.2918171296296297,6, 4, 2,gpt-3.5-turbo-Chat2
140,scammer_346,0.022407407407407407,13, 7, 6,gpt-4-Chat1
141,scammer_347,4.77175925925926,28, 15, 13,gpt-3.5-turbo-Chat2
142,scammer_349,3.272476851851852,6, 4, 2,gpt-4-Chat1
143,scammer_350,5.836388888888889,58, 45, 13,gpt-4-Chat1
144,scammer_354,0.07811342592592592,9, 5, 4,gpt-3.5-turbo-Chat2
145,scammer_355,0.02789351851851852,3, 2, 1,gpt-3.5-turbo-Chat2
146,scammer_357,2.0267476851851853,13, 7, 6,gpt-3.5-turbo-Chat2
147,scammer_358,0.8094212962962963,17, 13, 4,gpt-4-Chat1
148,scammer_359,10.08488425925926,27, 17, 10,gpt-4-Chat1
149,scammer_362,2.1734953703703703,7, 4, 3,gpt-4-Chat1
150,scammer_369,0.0,2, 1, 1,gpt-4-Chat1
151,scammer_371,9.752962962962963,66, 47, 19,gpt-4-Chat1
152,scammer_372,0.06770833333333333,7, 4, 3,gpt-4-Chat1
153,scammer_374,5.6513078703703705,18, 13, 5,gpt-4-Chat1
154,scammer_375,1.9655671296296295,16, 13, 3,gpt-4-Chat1
155,scammer_376,6.159664351851852,9, 5, 4,gpt-4-Chat1
156,scammer_377,0.07717592592592593,6, 3, 3,gpt-3.5-turbo-Chat2
157,scammer_380,1.0470023148148149,3, 2, 1,gpt-3.5-turbo-Chat2
158,scammer_381,5.582696759259259,29, 15, 14,gpt-3.5-turbo-Chat2
159,scammer_382,0.21561342592592592,6, 4, 2,gpt-3.5-turbo-Chat2
160,scammer_388,0.03068287037037037,16, 8, 8,gpt-3.5-turbo-Chat2
161,scammer_389,0.0007060185185185185,3, 2, 1,gpt-3.5-turbo-Chat2
162,scammer_390,6.364074074074074,55, 34, 21,gpt-3.5-turbo-Chat2
163,scammer_391,0.1255324074074074,94, 49, 45,gpt-3.5-turbo-Chat2
164,scammer_392,16.78238425925926,26, 17, 9,gpt-4-Chat1
165,scammer_394,2.8851851851851853,8, 4, 4,gpt-3.5-turbo-Chat2
166,scammer_395,0.7559027777777778,24, 20, 4,gpt-3.5-turbo-Chat2
167,scammer_401,0.2840509259259259,3, 2, 1,gpt-4-Chat1
168,scammer_403,2.987037037037037,9, 6, 3,gpt-4-Chat1
169,scammer_404,0.8979166666666667,6, 3, 3,gpt-3.5-turbo-Chat2
170,scammer_407,0.0,2, 1, 1,gpt-3.5-turbo-Chat2
171,scammer_408,6.73587962962963,8, 5, 3,gpt-3.5-turbo-Chat2
172,scammer_409,4.666458333333333,43, 22, 21,gpt-3.5-turbo-Chat2
173,scammer_411,0.028252314814814813,13, 7, 6,gpt-4-Chat1
174,scammer_412,0.25471064814814814,11, 6, 5,gpt-4-Chat1
175,scammer_414,2.3950694444444443,9, 6, 3,gpt-3.5-turbo-Chat2
176,scammer_419,0.00949074074074074,7, 4, 3,gpt-3.5-turbo-Chat2
177,scammer_422,4.3904861111111115,10, 6, 4,gpt-3.5-turbo-Chat2
178,scammer_425,0.0008101851851851852,3, 2, 1,gpt-4-Chat1
179,scammer_427,9.947557870370371,24, 13, 11,gpt-4-Chat1
180,scammer_428,0.0,2, 1, 1,gpt-4-Chat1
181,scammer_429,6.542951388888889,9, 5, 4,gpt-3.5-turbo-Chat2
182,scammer_435,6.914710648148148,15, 8, 7,gpt-3.5-turbo-Chat2
183,scammer_438,2.053263888888889,40, 32, 8,gpt-3.5-turbo-Chat2
184,scammer_440,0.16042824074074075,3, 2, 1,gpt-4-Chat1
185,scammer_445,4.376215277777778,5, 3, 2,gpt-3.5-turbo-Chat2
186,scammer_447,6.795775462962963,33, 20, 13,gpt-4-Chat1
187,scammer_453,0.005810185185185186,3, 2, 1,gpt-4-Chat1
188,scammer_455,4.418460648148148,5, 4, 1,gpt-4-Chat1
189,scammer_463,9.04429398148148,13, 6, 7,gpt-3.5-turbo-Chat2
190,scammer_464,6.033912037037037,14, 8, 6,gpt-3.5-turbo-Chat2
191,scammer_465,4.850023148148148,9, 6, 3,gpt-3.5-turbo-Chat2
192,scammer_466,0.2903472222222222,13, 12, 1,gpt-4-Chat1
193,scammer_467,0.7040856481481481,3, 2, 1,gpt-3.5-turbo-Chat2
194,scammer_472,7.239398148148148,18, 11, 7,gpt-3.5-turbo-Chat2
195,scammer_478,5.511712962962963,29, 15, 14,gpt-3.5-turbo-Chat2
196,scammer_481,0.0,2, 1, 1,gpt-4-Chat1
197,scammer_486,0.10788194444444445,4, 2, 2,gpt-3.5-turbo-Chat2
198,scammer_488,0.04951388888888889,9, 5, 4,gpt-4-Chat1
199,scammer_489,0.017395833333333333,9, 5, 4,gpt-4-Chat1
200,scammer_490,8.417233796296296,11, 7, 4,gpt-3.5-turbo-Chat2
201,scammer_494,6.577685185185185,15, 11, 4,gpt-3.5-turbo-Chat2
202,scammer_497,1.903900462962963,3, 2, 1,gpt-4-Chat1
203,scammer_503,0.00917824074074074,3, 2, 1,gpt-4-Chat1
204,scammer_504,6.112881944444444,9, 5, 4,gpt-4-Chat1
205,scammer_509,0.0503125,5, 3, 2,gpt-4-Chat1
206,scammer_515,0.15758101851851852,9, 5, 4,gpt-4-Chat1
207,scammer_516,16.598460648148148,9, 5, 4,gpt-3.5-turbo-Chat2
208,scammer_517,1.053576388888889,10, 5, 5,gpt-3.5-turbo-Chat2
209,scammer_519,0.7563657407407407,16, 13, 3,gpt-4-Chat1
210,scammer_520,7.066655092592592,17, 9, 8,gpt-4-Chat1
211,scammer_522,5.725578703703704,19, 11, 8,gpt-4-Chat1
212,scammer_524,0.0051967592592592595,3, 2, 1,gpt-4-Chat1
213,scammer_527,0.12506944444444446,6, 3, 3,gpt-4-Chat1
214,scammer_531,0.0,2, 1, 1,gpt-3.5-turbo-Chat2
215,scammer_537,17.868460648148147,33, 23, 10,gpt-3.5-turbo-Chat2
216,scammer_538,0.01324074074074074,12, 6, 6,gpt-3.5-turbo-Chat2
217,scammer_539,0.01885416666666667,3, 2, 1,gpt-3.5-turbo-Chat2
218,scammer_542,0.012835648148148148,7, 4, 3,gpt-4-Chat1
219,scammer_543,5.777256944444445,7, 4, 3,gpt-4-Chat1
220,scammer_545,9.958055555555555,18, 9, 9,gpt-4-Chat1
221,scammer_546,8.420590277777778,22, 12, 10,gpt-4-Chat1
222,scammer_547,27.37505787037037,32, 16, 16,gpt-4-Chat1
223,scammer_548,0.47215277777777775,7, 6, 1,gpt-3.5-turbo-Chat2
224,scammer_549,0.9332291666666667,10, 5, 5,gpt-4-Chat1
225,scammer_550,0.09810185185185186,8, 4, 4,gpt-3.5-turbo-Chat2
226,scammer_555,4.217326388888889,5, 3, 2,gpt-3.5-turbo-Chat2
227,scammer_556,21.03837962962963,5, 2, 3,gpt-4-Chat1
228,scammer_558,5.437094907407407,11, 6, 5,gpt-3.5-turbo-Chat2
229,scammer_560,24.20380787037037,18, 10, 8,gpt-3.5-turbo-Chat2
230,scammer_561,5.000277777777778,9, 6, 3,gpt-4-Chat1
231,scammer_562,7.852407407407408,11, 6, 5,gpt-3.5-turbo-Chat2
232,scammer_563,5.002916666666667,14, 7, 7,gpt-3.5-turbo-Chat2
233,scammer_567,5.666111111111111,28, 19, 9,gpt-4-Chat1
234,scammer_568,0.2904861111111111,8, 7, 1,gpt-3.5-turbo-Chat2
235,scammer_570,0.03462962962962963,7, 4, 3,gpt-4-Chat1
236,scammer_571,0.04292824074074074,4, 2, 2,gpt-3.5-turbo-Chat2
237,scammer_576,0.819212962962963,7, 4, 3,gpt-4-Chat1
238,scammer_579,9.267569444444444,7, 4, 3,gpt-4-Chat1
239,scammer_582,0.0,2, 1, 1,gpt-3.5-turbo-Chat2
240,scammer_589,0.0171875,3, 2, 1,gpt-3.5-turbo-Chat2
241,scammer_603,2.2519560185185186,7, 4, 3,gpt-3.5-turbo-Chat2
242,scammer_607,0.7690162037037037,13, 7, 6,gpt-4-Chat1
243,scammer_608,0.007893518518518518,3, 2, 1,gpt-4-Chat1
244,scammer_610,0.0007986111111111112,3, 2, 1,gpt-4-Chat1
245,scammer_611,0.0,2, 1, 1,gpt-3.5-turbo-Chat2
246,scammer_612,2.999247685185185,37, 30, 7,gpt-4-Chat1
247,scammer_613,0.12145833333333333,3, 2, 1,gpt-3.5-turbo-Chat2
248,scammer_621,0.02917824074074074,7, 4, 3,gpt-3.5-turbo-Chat2
249,scammer_622,0.8298842592592592,21, 12, 9,gpt-4-Chat1
250,scammer_625,0.00016203703703703703,3, 2, 1,gpt-3.5-turbo-Chat2
251,scammer_626,2.9117824074074075,6, 4, 2,gpt-3.5-turbo-Chat2
252,scammer_627,10.04111111111111,4, 2, 2,gpt-4-Chat1
253,scammer_635,4.771817129629629,48, 25, 23,gpt-3.5-turbo-Chat2
254,scammer_639,0.47912037037037036,7, 4, 3,gpt-3.5-turbo-Chat2
255,scammer_642,2.489027777777778,5, 3, 2,gpt-4-Chat1
256,scammer_643,0.006863425925925926,3, 2, 1,gpt-3.5-turbo-Chat2
257,scammer_644,2.1466319444444446,5, 3, 2,gpt-3.5-turbo-Chat2
258,scammer_646,1.0615625,12, 6, 6,gpt-3.5-turbo-Chat2
259,scammer_648,0.0002546296296296296,3, 2, 1,gpt-3.5-turbo-Chat2
260,scammer_649,4.508900462962963,10, 6, 4,gpt-3.5-turbo-Chat2
261,scammer_654,0.0,5, 3, 2,gpt-4-Chat1
262,scammer_655,0.0006712962962962962,4, 3, 1,gpt-4-Chat1
263,scammer_658,0.038391203703703705,3, 2, 1,gpt-4-Chat1
264,scammer_662,3.221875,23, 12, 11,gpt-3.5-turbo-Chat2
265,scammer_665,0.0,2, 1, 1,gpt-3.5-turbo-Chat2
266,scammer_666,0.18746527777777777,22, 12, 10,gpt-4-Chat1
267,scammer_674,4.063217592592593,11, 6, 5,gpt-4-Chat1
268,scammer_676,0.5082986111111111,29, 17, 12,gpt-3.5-turbo-Chat2
269,scammer_679,4.8968287037037035,40, 23, 17,gpt-4-Chat1
270,scammer_682,0.2858449074074074,8, 7, 1,gpt-4-Chat1
271,scammer_683,0.045474537037037036,14, 7, 7,gpt-3.5-turbo-Chat2
272,scammer_684,4.135856481481482,38, 20, 18,gpt-4-Chat1
273,scammer_685,0.4738773148148148,5, 3, 2,gpt-4-Chat1
274,scammer_688,2.978263888888889,6, 3, 3,gpt-3.5-turbo-Chat2
275,scammer_689,0.19744212962962962,9, 7, 2,gpt-4-Chat1
276,scammer_692,1.3920949074074074,3, 1, 2,gpt-3.5-turbo-Chat2
277,scammer_693,0.06572916666666667,5, 3, 2,gpt-4-Chat1
278,scammer_694,19.0475,75, 43, 32,gpt-3.5-turbo-Chat2
279,scammer_695,0.6643865740740741,37, 19, 18,gpt-3.5-turbo-Chat2
280,scammer_696,0.1561574074074074,9, 5, 4,gpt-4-Chat1
281,scammer_697,4.624907407407408,5, 3, 2,gpt-4-Chat1
282,scammer_702,16.84048611111111,15, 8, 7,gpt-3.5-turbo-Chat2
283,scammer_708,0.2169560185185185,9, 5, 4,gpt-3.5-turbo-Chat2
284,scammer_712,4.4990856481481485,10, 5, 5,gpt-4-Chat1
285,scammer_717,17.430497685185184,19, 10, 9,gpt-3.5-turbo-Chat2
286,scammer_718,0.013865740740740741,3, 2, 1,gpt-3.5-turbo-Chat2
287,scammer_719,5.816701388888889,5, 3, 2,gpt-4-Chat1
288,scammer_721,8.911284722222222,11, 7, 4,gpt-4-Chat1
289,scammer_722,0.00037037037037037035,3, 2, 1,gpt-3.5-turbo-Chat2
290,scammer_727,23.64434027777778,10, 5, 5,gpt-4-Chat1
291,scammer_728,1.103761574074074,4, 2, 2,gpt-4-Chat1
292,scammer_730,0.03908564814814815,3, 2, 1,gpt-4-Chat1
293,scammer_734,11.915335648148147,51, 30, 21,gpt-3.5-turbo-Chat2
294,scammer_735,0.0,2, 1, 1,gpt-3.5-turbo-Chat2
295,scammer_736,0.0006481481481481481,3, 2, 1,gpt-4-Chat1
296,scammer_739,6.044907407407408,14, 8, 6,gpt-4-Chat1
297,scammer_740,0.004756944444444445,9, 5, 4,gpt-3.5-turbo-Chat2
298,scammer_741,0.04185185185185185,7, 6, 1,gpt-4-Chat1
299,scammer_742,8.491747685185185,25, 13, 12,gpt-4-Chat1
300,scammer_743,0.13765046296296296,4, 2, 2,gpt-3.5-turbo-Chat2
301,scammer_748,0.44753472222222224,17, 9, 8,gpt-3.5-turbo-Chat2
302,scammer_755,3.144363425925926,12, 7, 5,gpt-4-Chat1
303,scammer_758,1.49375,4, 3, 1,gpt-3.5-turbo-Chat2
304,scammer_766,1.2480092592592593,17, 11, 6,gpt-4-Chat1
305,scammer_770,1.1833680555555555,12, 7, 5,gpt-3.5-turbo-Chat2
306,scammer_771,12.819050925925925,7, 4, 3,gpt-3.5-turbo-Chat2
307,scammer_772,5.215925925925926,21, 11, 10,gpt-4-Chat1
308,scammer_773,10.896400462962964,49, 27, 22,gpt-4-Chat1
309,scammer_774,12.065891203703703,5, 4, 1,gpt-3.5-turbo-Chat2
310,scammer_775,11.066481481481482,23, 18, 5,gpt-4-Chat1
311,scammer_777,0.0005092592592592592,3, 2, 1,gpt-3.5-turbo-Chat2
312,scammer_778,0.020555555555555556,5, 3, 2,gpt-3.5-turbo-Chat2
313,scammer_779,11.536493055555555,90, 47, 43,gpt-4-Chat1
314,scammer_781,7.295011574074074,20, 10, 10,gpt-3.5-turbo-Chat2
315,scammer_784,0.06253472222222223,9, 5, 4,gpt-3.5-turbo-Chat2
316,scammer_786,0.5834606481481481,4, 2, 2,gpt-4-Chat1
317,scammer_793,0.021516203703703704,4, 2, 2,gpt-3.5-turbo-Chat2
318,scammer_797,4.313564814814815,13, 12, 1,gpt-4-Chat1
319,scammer_801,4.1255092592592595,4, 2, 2,gpt-3.5-turbo-Chat2
320,scammer_802,0.00032407407407407406,3, 2, 1,gpt-4-Chat1
321,scammer_805,5.715740740740741,35, 19, 16,gpt-3.5-turbo-Chat2
322,scammer_806,0.09340277777777778,7, 4, 3,gpt-3.5-turbo-Chat2
323,scammer_809,6.906574074074074,59, 31, 28,gpt-4-Chat1
324,scammer_815,1.0417361111111112,18, 9, 9,gpt-4-Chat1
325,scammer_816,7.608634259259259,6, 3, 3,gpt-4-Chat1
326,scammer_821,1.1562037037037036,26, 19, 7,gpt-4-Chat1
327,scammer_822,0.572662037037037,10, 8, 2,gpt-3.5-turbo-Chat2
328,scammer_826,4.230381944444445,20, 15, 5,gpt-3.5-turbo-Chat2
329,scammer_828,0.13708333333333333,9, 8, 1,gpt-3.5-turbo-Chat2
330,scammer_830,7.288240740740741,15, 8, 7,gpt-3.5-turbo-Chat2
331,scammer_832,0.00045138888888888887,3, 2, 1,gpt-4-Chat1
332,scammer_837,12.90324074074074,45, 32, 13,gpt-4-Chat1
333,scammer_843,0.2311574074074074,9, 5, 4,gpt-3.5-turbo-Chat2
334,scammer_846,0.8215972222222222,20, 13, 7,gpt-3.5-turbo-Chat2
335,scammer_849,6.119641203703703,12, 7, 5,gpt-3.5-turbo-Chat2
336,scammer_850,23.223425925925927,42, 24, 18,gpt-4-Chat1
337,scammer_852,0.81125,8, 4, 4,gpt-3.5-turbo-Chat2
338,scammer_853,5.127407407407407,34, 19, 15,gpt-4-Chat1
339,scammer_860,0.020057870370370372,5, 3, 2,gpt-4-Chat1
340,scammer_865,0.03484953703703704,4, 2, 2,gpt-4-Chat1
341,scammer_867,0.0032523148148148147,7, 4, 3,gpt-4-Chat1
342,scammer_869,3.480324074074074,6, 3, 3,gpt-3.5-turbo-Chat2
343,scammer_871,8.146608796296297,11, 6, 5,gpt-4-Chat1
344,scammer_883,0.01744212962962963,5, 3, 2,gpt-3.5-turbo-Chat2
345,scammer_884,4.302152777777778,6, 3, 3,gpt-3.5-turbo-Chat2
346,scammer_886,0.06800925925925926,3, 2, 1,gpt-3.5-turbo-Chat2
347,scammer_888,6.039027777777778,21, 11, 10,gpt-3.5-turbo-Chat2
348,scammer_889,0.9064583333333334,10, 6, 4,gpt-4-Chat1
349,scammer_894,4.964756944444445,3, 2, 1,gpt-4-Chat1
350,scammer_895,0.004398148148148148,5, 3, 2,gpt-4-Chat1
351,scammer_900,10.064398148148149,33, 19, 14,gpt-4-Chat1
352,scammer_912,0.01888888888888889,3, 2, 1,gpt-3.5-turbo-Chat2
353,scammer_913,0.4814236111111111,5, 3, 2,gpt-3.5-turbo-Chat2
354,scammer_915,0.03774305555555556,10, 7, 3,gpt-4-Chat1
355,scammer_921,0.004479166666666667,3, 2, 1,gpt-3.5-turbo-Chat2
356,scammer_922,0.0,2, 1, 1,gpt-3.5-turbo-Chat2
357,scammer_924,0.17818287037037037,6, 5, 1,gpt-3.5-turbo-Chat2
358,scammer_925,1.722013888888889,16, 12, 4,gpt-3.5-turbo-Chat2
359,scammer_929,15.275208333333333,29, 19, 10,gpt-4-Chat1
360,scammer_934,0.0,2, 1, 1,gpt-4-Chat1
361,scammer_935,17.458715277777777,42, 28, 14,gpt-3.5-turbo-Chat2
362,scammer_940,0.11280092592592593,44, 24, 20,gpt-4-Chat1
363,scammer_941,0.3910763888888889,5, 4, 1,gpt-4-Chat1
364,scammer_950,0.0,2, 1, 1,gpt-3.5-turbo-Chat2
365,scammer_951,18.914583333333333,14, 9, 5,gpt-3.5-turbo-Chat2
366,scammer_964,0.007245370370370371,6, 4, 2,gpt-4-Chat1
367,scammer_966,0.0,2, 1, 1,gpt-4-Chat1
368,scammer_967,15.656226851851851,66, 36, 30,gpt-3.5-turbo-Chat2
369,scammer_969,5.496377314814815,31, 17, 14,gpt-3.5-turbo-Chat2
370,scammer_974,8.054131944444444,16, 9, 7,gpt-4-Chat1
371,scammer_976,6.298680555555555,21, 11, 10,gpt-4-Chat1
372,scammer_981,0.06318287037037038,8, 4, 4,gpt-4-Chat1
373,scammer_982,0.0030555555555555557,3, 2, 1,gpt-4-Chat1
374,scammer_983,8.52,13, 7, 6,gpt-3.5-turbo-Chat2
375,scammer_984,2.416087962962963,4, 2, 2,gpt-4-Chat1
376,scammer_987,4.070613425925926,11, 6, 5,gpt-3.5-turbo-Chat2
377,scammer_989,1.3347685185185185,10, 8, 2,gpt-4-Chat1
378,scammer_991,0.018784722222222223,3, 2, 1,gpt-4-Chat1
379,scammer_992,4.7496875,28, 14, 14,gpt-4-Chat1
380,scammer_993,5.748900462962963,20, 13, 7,gpt-4-Chat1
381,scammer_995,4.891724537037037,5, 3, 2,gpt-4-Chat1
382,scammer_996,0.0004976851851851852,3, 2, 1,gpt-3.5-turbo-Chat2
383,scammer_998,0.13087962962962962,5, 3, 2,gpt-4-Chat1
384,scammer_999,3.3537037037037036,38, 20, 18,gpt-4-Chat1
385,scammer_1002,1.1752083333333334,13, 7, 6,gpt-3.5-turbo-Chat2
386,scammer_1003,5.787037037037037e-05,3, 2, 1,gpt-3.5-turbo-Chat2
387,scammer_1004,0.9679050925925926,58, 31, 27,gpt-3.5-turbo-Chat2
388,scammer_1005,4.292939814814815,9, 5, 4,gpt-3.5-turbo-Chat2
389,scammer_1006,0.0013194444444444445,4, 3, 1,gpt-3.5-turbo-Chat2
390,scammer_1008,5.351388888888889,21, 12, 9,gpt-4-Chat1
391,scammer_1016,0.0004166666666666667,3, 2, 1,gpt-3.5-turbo-Chat2
392,scammer_1019,0.061203703703703705,11, 5, 6,gpt-3.5-turbo-Chat2
393,scammer_1024,0.014016203703703704,5, 3, 2,gpt-4-Chat1
394,scammer_1025,0.02369212962962963,3, 2, 1,gpt-4-Chat1
395,scammer_1026,5.1375,16, 9, 7,gpt-3.5-turbo-Chat2
396,scammer_1028,4.022962962962963,9, 5, 4,gpt-3.5-turbo-Chat2
397,scammer_1029,9.021342592592593,35, 19, 16,gpt-3.5-turbo-Chat2
398,scammer_1033,17.31685185185185,7, 4, 3,gpt-4-Chat1
399,scammer_1037,3.1795949074074072,5, 3, 2,gpt-4-Chat1
400,scammer_1038,0.007199074074074074,6, 4, 2,gpt-4-Chat1
401,scammer_1044,0.00619212962962963,7, 5, 2,gpt-3.5-turbo-Chat2
402,scammer_1047,0.03892361111111111,4, 2, 2,gpt-4-Chat1
403,scammer_1049,1.8265277777777778,29, 22, 7,gpt-4-Chat1
404,scammer_1052,5.0001851851851855,8, 5, 3,gpt-4-Chat1
405,scammer_1066,0.0,2, 1, 1,gpt-3.5-turbo-Chat2
406,scammer_1067,0.001099537037037037,4, 3, 1,gpt-3.5-turbo-Chat2
407,scammer_1068,0.6649074074074074,18, 11, 7,gpt-4-Chat1
408,scammer_1070,0.0006597222222222222,3, 2, 1,gpt-3.5-turbo-Chat2
409,scammer_1073,0.0,2, 1, 1,gpt-4-Chat1
410,scammer_1074,11.335694444444444,14, 8, 6,gpt-3.5-turbo-Chat2
411,scammer_1075,0.00024305555555555555,3, 2, 1,gpt-3.5-turbo-Chat2
412,scammer_1076,1.0048958333333333,10, 7, 3,gpt-3.5-turbo-Chat2
413,scammer_1077,0.26136574074074076,7, 4, 3,gpt-3.5-turbo-Chat2
414,scammer_1080,0.0030208333333333333,3, 2, 1,gpt-3.5-turbo-Chat2
415,scammer_1082,0.1253240740740741,5, 3, 2,gpt-3.5-turbo-Chat2
416,scammer_1083,0.0,2, 1, 1,gpt-3.5-turbo-Chat2
417,scammer_1085,0.9999537037037037,8, 4, 4,gpt-4-Chat1
418,scammer_1086,0.7406712962962962,12, 6, 6,gpt-4-Chat1
419,scammer_1087,0.625150462962963,18, 15, 3,gpt-3.5-turbo-Chat2
420,scammer_1093,0.001990740740740741,3, 2, 1,gpt-3.5-turbo-Chat2
421,scammer_1095,0.0,2, 1, 1,gpt-4-Chat1
422,scammer_1096,0.06800925925925926,5, 3, 2,gpt-4-Chat1
423,scammer_1099,0.35502314814814817,15, 8, 7,gpt-4-Chat1
424,scammer_1101,0.0,2, 1, 1,gpt-4-Chat1
425,scammer_1105,0.0,2, 1, 1,gpt-3.5-turbo-Chat2
426,scammer_1110,1.4583912037037037,12, 6, 6,gpt-4-Chat1
427,scammer_1111,0.0007407407407407407,3, 2, 1,gpt-4-Chat1
428,scammer_1112,3.6475115740740742,19, 14, 5,gpt-3.5-turbo-Chat2
429,scammer_1114,0.5396180555555555,11, 7, 4,gpt-3.5-turbo-Chat2
430,scammer_1115,4.454108796296296,7, 4, 3,gpt-4-Chat1
431,scammer_1117,0.023113425925925926,3, 2, 1,gpt-3.5-turbo-Chat2
432,scammer_1119,2.893449074074074,3, 2, 1,gpt-4-Chat1
433,scammer_1124,0.007222222222222222,3, 2, 1,gpt-3.5-turbo-Chat2
434,scammer_1125,0.0,2, 1, 1,gpt-3.5-turbo-Chat2
435,scammer_1127,1.4580671296296297,5, 3, 2,gpt-3.5-turbo-Chat2
436,scammer_1130,0.0062037037037037035,4, 2, 2,gpt-3.5-turbo-Chat2
437,scammer_1131,0.00849537037037037,3, 2, 1,gpt-3.5-turbo-Chat2
438,scammer_1132,0.001574074074074074,3, 2, 1,gpt-3.5-turbo-Chat2
439,scammer_1135,2.022488425925926,7, 4, 3,gpt-3.5-turbo-Chat2
440,scammer_1136,0.012118055555555556,11, 7, 4,gpt-3.5-turbo-Chat2
441,scammer_1137,4.562013888888889,5, 3, 2,gpt-4-Chat1
442,scammer_1138,0.021875,6, 3, 3,gpt-4-Chat1
443,scammer_1141,1.0399421296296296,31, 19, 12,gpt-3.5-turbo-Chat2
444,scammer_1142,1.1056018518518518,10, 5, 5,gpt-3.5-turbo-Chat2
445,scammer_1148,3.00125,38, 20, 18,gpt-4-Chat1
446,scammer_1153,0.01394675925925926,5, 3, 2,gpt-3.5-turbo-Chat2
447,scammer_1163,0.09557870370370371,6, 5, 1,gpt-4-Chat1
448,scammer_1166,3.9897916666666666,6, 3, 3,gpt-4-Chat1
449,scammer_1167,4.829537037037037,7, 4, 3,gpt-3.5-turbo-Chat2
450,scammer_1176,0.05243055555555556,16, 9, 7,gpt-4-Chat1
451,scammer_1178,1.9167013888888889,11, 7, 4,gpt-4-Chat1
452,scammer_1180,0.1381712962962963,9, 5, 4,gpt-4-Chat1
453,scammer_1183,1.1569212962962963,32, 19, 13,gpt-4-Chat1
454,scammer_1184,0.0006481481481481481,3, 2, 1,gpt-4-Chat1
455,scammer_1185,0.022349537037037036,19, 11, 8,gpt-4-Chat1
456,scammer_1187,4.355752314814815,14, 8, 6,gpt-4-Chat1
457,scammer_1189,0.0017476851851851852,3, 2, 1,gpt-4-Chat1
458,scammer_1191,14.216863425925926,16, 12, 4,gpt-4-Chat1
459,scammer_1192,1.1502546296296297,5, 3, 2,gpt-4-Chat1
460,scammer_1194,0.7742361111111111,3, 2, 1,gpt-4-Chat1
461,scammer_1199,7.371736111111111,27, 14, 13,gpt-3.5-turbo-Chat2
462,scammer_1200,0.0,2, 1, 1,gpt-3.5-turbo-Chat2
463,scammer_1202,18.46898148148148,5, 3, 2,gpt-3.5-turbo-Chat2
464,scammer_1203,6.4526157407407405,39, 20, 19,gpt-3.5-turbo-Chat2
465,scammer_1206,0.0,2, 1, 1,gpt-3.5-turbo-Chat2
466,scammer_1212,4.495150462962963,3, 2, 1,gpt-3.5-turbo-Chat2
467,scammer_1215,0.014652777777777778,3, 2, 1,gpt-3.5-turbo-Chat2
468,scammer_1216,5.882002314814815,13, 7, 6,gpt-3.5-turbo-Chat2
469,scammer_1217,0.059675925925925924,5, 3, 2,gpt-3.5-turbo-Chat2
470,scammer_1219,5.741365740740741,23, 13, 10,gpt-4-Chat1
471,scammer_1221,0.2596643518518518,7, 4, 3,gpt-4-Chat1
472,scammer_1227,0.35032407407407407,5, 3, 2,gpt-4-Chat1
473,scammer_1230,0.007210648148148148,3, 2, 1,gpt-4-Chat1
474,scammer_1231,5.592361111111111,9, 5, 4,gpt-3.5-turbo-Chat2
475,scammer_1232,3.711053240740741,5, 3, 2,gpt-3.5-turbo-Chat2
476,scammer_1233,0.0007175925925925926,3, 2, 1,gpt-4-Chat1
477,scammer_1243,3.3757407407407407,4, 2, 2,gpt-3.5-turbo-Chat2
478,scammer_1244,0.4027777777777778,3, 2, 1,gpt-3.5-turbo-Chat2
479,scammer_1254,2.765173611111111,20, 10, 10,gpt-4-Chat1
480,scammer_1256,0.0,2, 1, 1,gpt-4-Chat1
481,scammer_1257,1.4369560185185186,5, 3, 2,gpt-4-Chat1
482,scammer_1262,4.064120370370371,14, 10, 4,gpt-3.5-turbo-Chat2
483,scammer_1264,0.0,2, 1, 1,gpt-4-Chat1
484,scammer_1265,0.0002546296296296296,3, 2, 1,gpt-3.5-turbo-Chat2
485,scammer_1270,2.908888888888889,15, 9, 6,gpt-3.5-turbo-Chat2
486,scammer_1274,8.318148148148149,33, 18, 15,gpt-3.5-turbo-Chat2
487,scammer_1275,18.886122685185185,442, 254, 188,gpt-3.5-turbo-Chat2
488,scammer_1276,0.0,2, 1, 1,gpt-3.5-turbo-Chat2
489,scammer_1279,22.961030092592594,60, 40, 20,gpt-3.5-turbo-Chat2
490,scammer_1280,0.7111342592592592,24, 19, 5,gpt-4-Chat1
491,scammer_1285,1.060289351851852,3, 2, 1,gpt-4-Chat1
492,scammer_1288,1.749976851851852,10, 5, 5,gpt-4-Chat1
493,scammer_1289,0.6047337962962963,3, 2, 1,gpt-3.5-turbo-Chat2
494,scammer_1291,0.006458333333333333,5, 3, 2,gpt-3.5-turbo-Chat2
495,scammer_1293,4.4057407407407405,39, 29, 10,gpt-3.5-turbo-Chat2
496,scammer_1295,0.0002662037037037037,3, 2, 1,gpt-4-Chat1
497,scammer_1296,0.009606481481481481,7, 4, 3,gpt-4-Chat1
498,scammer_1297,31.35542824074074,23, 14, 9,gpt-4-Chat1
499,scammer_1306,8.124791666666667,10, 7, 3,gpt-4-Chat1
500,scammer_1312,3.3869212962962965,11, 6, 5,gpt-4-Chat1
501,scammer_1313,0.15765046296296295,3, 2, 1,gpt-3.5-turbo-Chat2
502,scammer_1314,10.016736111111111,4, 2, 2,gpt-4-Chat1
503,scammer_1316,1.8922569444444444,25, 19, 6,gpt-3.5-turbo-Chat2
504,scammer_1317,5.96525462962963,61, 31, 30,gpt-3.5-turbo-Chat2
505,scammer_1319,0.01494212962962963,3, 2, 1,gpt-3.5-turbo-Chat2
506,scammer_1321,0.07188657407407407,19, 10, 9,gpt-3.5-turbo-Chat2
507,scammer_1328,4.876863425925926,31, 16, 15,gpt-3.5-turbo-Chat2
508,scammer_1330,0.040393518518518516,9, 6, 3,gpt-3.5-turbo-Chat2
509,scammer_1332,0.1723726851851852,9, 5, 4,gpt-3.5-turbo-Chat2
510,scammer_1335,1.532650462962963,61, 31, 30,gpt-4-Chat1
511,scammer_1336,2.624791666666667,5, 3, 2,gpt-4-Chat1
512,scammer_1339,5.823981481481481,27, 15, 12,gpt-3.5-turbo-Chat2
513,scammer_1340,0.3749189814814815,6, 3, 3,gpt-4-Chat1
514,scammer_1342,11.50258101851852,52, 29, 23,gpt-4-Chat1
515,scammer_1343,4.915960648148148,8, 5, 3,gpt-4-Chat1
516,scammer_1344,0.0005671296296296297,3, 2, 1,gpt-4-Chat1
517,scammer_1345,9.913530092592593,30, 22, 8,gpt-4-Chat1
518,scammer_1350,16.98068287037037,16, 8, 8,gpt-4-Chat1
519,scammer_1354,0.01224537037037037,3, 2, 1,gpt-4-Chat1
520,scammer_1356,0.1253240740740741,10, 8, 2,gpt-4-Chat1
521,scammer_1358,2.332638888888889,30, 23, 7,gpt-3.5-turbo-Chat2
522,scammer_1359,19.093101851851852,43, 23, 20,gpt-4-Chat1
523,scammer_1361,9.014097222222222,20, 16, 4,gpt-4-Chat1
524,scammer_1364,0.0,2, 1, 1,gpt-4-Chat1
525,scammer_1371,7.189375,17, 9, 8,gpt-3.5-turbo-Chat2
526,scammer_1374,3.1367708333333333,36, 27, 9,gpt-3.5-turbo-Chat2
527,scammer_1376,0.010277777777777778,3, 2, 1,gpt-4-Chat1
528,scammer_1378,0.023877314814814816,5, 3, 2,gpt-3.5-turbo-Chat2
529,scammer_1379,2.9998263888888888,14, 7, 7,gpt-3.5-turbo-Chat2
530,scammer_1381,1.3149305555555555,51, 26, 25,gpt-3.5-turbo-Chat2
531,scammer_1384,8.839641203703703,9, 5, 4,gpt-3.5-turbo-Chat2
532,scammer_1386,0.7236689814814815,4, 2, 2,gpt-3.5-turbo-Chat2
533,scammer_1388,13.512453703703704,21, 11, 10,gpt-4-Chat1
534,scammer_1390,2.5739236111111112,7, 4, 3,gpt-3.5-turbo-Chat2
535,scammer_1392,6.436956018518519,9, 5, 4,gpt-3.5-turbo-Chat2
536,scammer_1393,0.06520833333333333,10, 6, 4,gpt-4-Chat1
537,scammer_1395,0.024421296296296295,3, 2, 1,gpt-4-Chat1
538,scammer_1397,2.3558680555555553,8, 5, 3,gpt-4-Chat1
539,scammer_1400,24.964375,21, 12, 9,gpt-3.5-turbo-Chat2
540,scammer_1401,0.3943171296296296,3, 2, 1,gpt-3.5-turbo-Chat2
541,scammer_1404,0.0005092592592592592,3, 2, 1,gpt-4-Chat1
542,scammer_1405,1.8871412037037036,10, 6, 4,gpt-3.5-turbo-Chat2
543,scammer_1406,2.468935185185185,6, 5, 1,gpt-3.5-turbo-Chat2
544,scammer_1408,4.276736111111111,9, 5, 4,gpt-3.5-turbo-Chat2
545,scammer_1418,7.815324074074074,13, 7, 6,gpt-4-Chat1
546,scammer_1419,0.8692129629629629,5, 3, 2,gpt-3.5-turbo-Chat2
547,scammer_1423,5.813217592592593,11, 7, 4,gpt-4-Chat1
548,scammer_1425,4.457835648148148,7, 4, 3,gpt-3.5-turbo-Chat2
549,scammer_1427,5.287719907407407,16, 9, 7,gpt-4-Chat1
550,scammer_1429,1.0116666666666667,5, 3, 2,gpt-4-Chat1
551,scammer_1434,1.4924652777777778,5, 3, 2,gpt-4-Chat1
552,scammer_1436,0.03197916666666667,5, 3, 2,gpt-3.5-turbo-Chat2
553,scammer_1437,0.0,2, 1, 1,gpt-3.5-turbo-Chat2
554,scammer_1439,0.04552083333333334,5, 3, 2,gpt-4-Chat1
555,scammer_1441,0.3835300925925926,10, 5, 5,gpt-3.5-turbo-Chat2
556,scammer_1442,5.855983796296297,14, 8, 6,gpt-3.5-turbo-Chat2
557,scammer_1447,0.021435185185185186,4, 2, 2,gpt-3.5-turbo-Chat2
558,scammer_1448,31.231620370370372,46, 23, 23,gpt-3.5-turbo-Chat2
559,scammer_1449,1.8754513888888888,30, 25, 5,gpt-4-Chat1
560,scammer_1452,0.5963541666666666,7, 3, 4,gpt-3.5-turbo-Chat2
561,scammer_1454,0.000462962962962963,3, 2, 1,gpt-4-Chat1
562,scammer_1457,0.0005208333333333333,4, 3, 1,gpt-4-Chat1
563,scammer_1458,0.024849537037037038,7, 4, 3,gpt-3.5-turbo-Chat2
564,scammer_1459,2.514386574074074,5, 3, 2,gpt-3.5-turbo-Chat2
565,scammer_1461,3.0312847222222223,5, 3, 2,gpt-4-Chat1
566,scammer_1462,3.063159722222222,4, 2, 2,gpt-4-Chat1
567,scammer_1463,0.1249537037037037,4, 2, 2,gpt-3.5-turbo-Chat2
568,scammer_1464,0.05331018518518518,32, 17, 15,gpt-3.5-turbo-Chat2
569,scammer_1466,0.04083333333333333,3, 2, 1,gpt-4-Chat1
570,scammer_1469,4.526805555555556,20, 11, 9,gpt-4-Chat1
571,scammer_1473,1.2621875,36, 23, 13,gpt-3.5-turbo-Chat2
572,scammer_1479,1.5581712962962964,14, 8, 6,gpt-3.5-turbo-Chat2
573,scammer_1483,3.8094907407407406,3, 2, 1,gpt-3.5-turbo-Chat2
574,scammer_1484,4.15630787037037,5, 3, 2,gpt-3.5-turbo-Chat2
575,scammer_1486,0.022511574074074073,3, 2, 1,gpt-4-Chat1
576,scammer_1492,0.013032407407407407,11, 6, 5,gpt-3.5-turbo-Chat2
577,scammer_1494,0.005,5, 3, 2,gpt-4-Chat1
578,scammer_1495,12.115613425925925,17, 9, 8,gpt-3.5-turbo-Chat2
579,scammer_1496,2.7741435185185184,6, 4, 2,gpt-3.5-turbo-Chat2
580,scammer_1498,3.4399652777777776,10, 6, 4,gpt-3.5-turbo-Chat2
581,scammer_1506,0.0007175925925925926,5, 3, 2,gpt-4-Chat1
582,scammer_1508,0.7117592592592593,9, 7, 2,gpt-4-Chat1
583,scammer_1513,0.001863425925925926,3, 2, 1,gpt-4-Chat1
584,scammer_1519,0.01787037037037037,3, 2, 1,gpt-4-Chat1
585,scammer_1521,2.988888888888889,5, 3, 2,gpt-3.5-turbo-Chat2
586,scammer_1523,2.291215277777778,13, 7, 6,gpt-3.5-turbo-Chat2
587,scammer_1525,0.49688657407407405,3, 2, 1,gpt-3.5-turbo-Chat2
588,scammer_1528,0.2427314814814815,11, 9, 2,gpt-3.5-turbo-Chat2
589,scammer_1529,1.0637037037037036,10, 6, 4,gpt-4-Chat1
590,scammer_1531,4.029178240740741,25, 13, 12,gpt-3.5-turbo-Chat2
591,scammer_1534,1.3510648148148148,3, 2, 1,gpt-4-Chat1
592,scammer_1535,6.792847222222222,25, 13, 12,gpt-4-Chat1
593,scammer_1537,3.2280671296296295,14, 9, 5,gpt-4-Chat1
594,scammer_1542,4.061817129629629,4, 2, 2,gpt-4-Chat1
595,scammer_1543,9.068460648148148,24, 13, 11,gpt-4-Chat1
596,scammer_1545,10.020266203703704,14, 8, 6,gpt-4-Chat1
597,scammer_1546,11.711342592592592,16, 9, 7,gpt-4-Chat1
598,scammer_1547,0.37516203703703704,20, 10, 10,gpt-4-Chat1
599,scammer_1549,5.286203703703704,3, 2, 1,gpt-3.5-turbo-Chat2
600,scammer_1556,6.226828703703704,34, 17, 17,gpt-4-Chat1
601,scammer_1564,0.033483796296296296,19, 10, 9,gpt-3.5-turbo-Chat2
602,scammer_1565,0.00042824074074074075,3, 2, 1,gpt-4-Chat1
603,scammer_1566,0.0005555555555555556,5, 3, 2,gpt-4-Chat1
604,scammer_1571,4.945069444444444,16, 12, 4,gpt-3.5-turbo-Chat2
605,scammer_1573,6.331145833333333,8, 3, 5,gpt-3.5-turbo-Chat2
606,scammer_1574,0.03737268518518518,4, 3, 1,gpt-3.5-turbo-Chat2
607,scammer_1578,8.074050925925926,19, 10, 9,gpt-3.5-turbo-Chat2
608,scammer_1583,0.18302083333333333,7, 4, 3,gpt-4-Chat1
609,scammer_1585,1.1369212962962962,13, 7, 6,gpt-4-Chat1
610,scammer_1586,0.0,2, 1, 1,gpt-3.5-turbo-Chat2
611,scammer_1592,2.072037037037037,8, 5, 3,gpt-4-Chat1
612,scammer_1595,4.514282407407407,11, 7, 4,gpt-3.5-turbo-Chat2
613,scammer_1597,0.15936342592592592,24, 13, 11,gpt-3.5-turbo-Chat2
614,scammer_1601,0.018391203703703705,3, 2, 1,gpt-4-Chat1
615,scammer_1604,0.015717592592592592,3, 2, 1,gpt-4-Chat1
616,scammer_1605,13.850844907407408,61, 39, 22,gpt-4-Chat1
617,scammer_1608,24.965046296296297,58, 35, 23,gpt-4-Chat1
618,scammer_1611,0.08971064814814815,11, 6, 5,gpt-4-Chat1
619,scammer_1612,5.062337962962963,9, 5, 4,gpt-3.5-turbo-Chat2
620,scammer_1613,5.721689814814815,5, 3, 2,gpt-3.5-turbo-Chat2
621,scammer_1615,3.544027777777778,32, 20, 12,gpt-3.5-turbo-Chat2
622,scammer_1623,0.04971064814814815,7, 4, 3,gpt-4-Chat1
623,scammer_1625,0.9800578703703704,11, 6, 5,gpt-3.5-turbo-Chat2
624,scammer_1626,0.027395833333333335,3, 2, 1,gpt-4-Chat1
625,scammer_1627,13.265659722222223,19, 15, 4,gpt-3.5-turbo-Chat2
626,scammer_1631,6.083460648148148,4, 2, 2,gpt-4-Chat1
627,scammer_1634,2.1528009259259258,5, 3, 2,gpt-3.5-turbo-Chat2
628,scammer_1638,0.43320601851851853,6, 4, 2,gpt-3.5-turbo-Chat2
629,scammer_1640,1.6575925925925925,9, 4, 5,gpt-4-Chat1
630,scammer_1642,1.0477199074074075,62, 37, 25,gpt-3.5-turbo-Chat2
631,scammer_1643,17.587245370370372,9, 5, 4,gpt-3.5-turbo-Chat2
632,scammer_1647,0.05078703703703704,5, 4, 1,gpt-4-Chat1
633,scammer_1650,0.0,2, 1, 1,gpt-4-Chat1
634,scammer_1651,28.249699074074073,4, 2, 2,gpt-3.5-turbo-Chat2
635,scammer_1653,5.171273148148148,3, 2, 1,gpt-4-Chat1
636,scammer_1655,0.0,2, 1, 1,gpt-4-Chat1
637,scammer_1657,13.374803240740741,15, 8, 7,gpt-4-Chat1
638,scammer_1658,0.011180555555555555,5, 3, 2,gpt-4-Chat1
639,scammer_1659,7.332997685185185,16, 9, 7,gpt-4-Chat1
640,scammer_1661,0.0,2, 1, 1,gpt-3.5-turbo-Chat2
641,scammer_1662,0.0,2, 1, 1,gpt-4-Chat1
642,scammer_1663,5.994212962962963,27, 14, 13,gpt-3.5-turbo-Chat2
643,scammer_1666,0.010601851851851852,9, 5, 4,gpt-3.5-turbo-Chat2
644,scammer_1672,5.6326273148148145,23, 12, 11,gpt-4-Chat1
645,scammer_1674,0.000462962962962963,3, 2, 1,gpt-4-Chat1
646,scammer_1675,0.30506944444444445,18, 14, 4,gpt-3.5-turbo-Chat2
647,scammer_1679,0.0,2, 1, 1,gpt-4-Chat1
648,scammer_1680,0.00034722222222222224,3, 2, 1,gpt-3.5-turbo-Chat2
649,scammer_1681,3.380636574074074,5, 3, 2,gpt-4-Chat1
650,scammer_1684,0.37991898148148145,19, 10, 9,gpt-4-Chat1
651,scammer_1685,0.0725,5, 3, 2,gpt-4-Chat1
652,scammer_1686,4.159872685185185,3, 2, 1,gpt-3.5-turbo-Chat2
653,scammer_1689,5.30244212962963,25, 14, 11,gpt-4-Chat1
654,scammer_1694,3.938113425925926,11, 6, 5,gpt-4-Chat1
655,scammer_1701,7.3934375,10, 6, 4,gpt-3.5-turbo-Chat2
656,scammer_1702,5.560613425925926,5, 3, 2,gpt-3.5-turbo-Chat2
657,scammer_1703,4.686944444444444,3, 2, 1,gpt-3.5-turbo-Chat2
658,scammer_1708,3.797997685185185,21, 13, 8,gpt-4-Chat1
659,scammer_1712,4.438599537037037,15, 8, 7,gpt-3.5-turbo-Chat2
660,scammer_1715,3.2546180555555555,54, 44, 10,gpt-4-Chat1
661,scammer_1716,0.005405092592592592,6, 4, 2,gpt-3.5-turbo-Chat2
662,scammer_1717,10.099166666666667,20, 10, 10,gpt-3.5-turbo-Chat2
663,scammer_1718,5.939618055555556,5, 3, 2,gpt-3.5-turbo-Chat2
664,scammer_1720,0.0,2, 1, 1,gpt-4-Chat1
665,scammer_1722,0.6180092592592593,6, 3, 3,gpt-4-Chat1
666,scammer_1725,20.093657407407406,10, 1, 9,gpt-4-Chat1
667,scammer_1727,31.30065972222222,17, 9, 8,gpt-3.5-turbo-Chat2
668,scammer_1729,0.2363888888888889,3, 2, 1,gpt-4-Chat1
669,scammer_1730,4.673819444444445,5, 3, 2,gpt-3.5-turbo-Chat2
670,scammer_1738,0.0006944444444444445,3, 2, 1,gpt-3.5-turbo-Chat2
671,scammer_1741,0.045856481481481484,4, 2, 2,gpt-4-Chat1
672,scammer_1746,5.648333333333333,17, 9, 8,gpt-3.5-turbo-Chat2
673,scammer_1748,12.498634259259259,29, 21, 8,gpt-4-Chat1
674,scammer_1752,2.124560185185185,8, 5, 3,gpt-4-Chat1
675,scammer_1753,1.9230092592592594,5, 3, 2,gpt-4-Chat1
676,scammer_1755,0.017465277777777777,5, 3, 2,gpt-4-Chat1
677,scammer_1756,2.124560185185185,3, 2, 1,gpt-3.5-turbo-Chat2
678,scammer_1763,4.085439814814815,7, 5, 2,gpt-4-Chat1
679,scammer_1766,0.12530092592592593,12, 6, 6,gpt-4-Chat1
680,scammer_1773,1.7903819444444444,20, 14, 6,gpt-4-Chat1
681,scammer_1774,4.083483796296297,4, 2, 2,gpt-4-Chat1
682,scammer_1776,2.434710648148148,23, 12, 11,gpt-3.5-turbo-Chat2
683,scammer_1777,0.000462962962962963,3, 2, 1,gpt-4-Chat1
684,scammer_1783,0.32188657407407406,6, 3, 3,gpt-4-Chat1
685,scammer_1785,2.431423611111111,15, 7, 8,gpt-3.5-turbo-Chat2
686,scammer_1787,13.021840277777779,5, 4, 1,gpt-4-Chat1
687,scammer_1788,5.7007060185185185,11, 8, 3,gpt-4-Chat1
688,scammer_1793,0.029502314814814815,6, 3, 3,gpt-4-Chat1
689,scammer_1795,0.13886574074074073,3, 2, 1,gpt-3.5-turbo-Chat2
690,scammer_1797,4.499722222222222,5, 3, 2,gpt-3.5-turbo-Chat2
691,scammer_1798,0.0008217592592592593,3, 2, 1,gpt-4-Chat1
692,scammer_1800,0.03871527777777778,13, 7, 6,gpt-3.5-turbo-Chat2
693,scammer_1801,0.0004398148148148148,3, 2, 1,gpt-4-Chat1
694,scammer_1804,0.006354166666666667,3, 2, 1,gpt-4-Chat1
695,scammer_1807,0.6986111111111111,3, 2, 1,gpt-4-Chat1
696,scammer_1810,4.938611111111111,12, 7, 5,gpt-4-Chat1
697,scammer_1813,7.880173611111111,9, 5, 4,gpt-4-Chat1
698,scammer_1814,0.888125,5, 3, 2,gpt-4-Chat1
699,scammer_1817,0.11346064814814814,3, 2, 1,gpt-4-Chat1
700,scammer_1818,5.50630787037037,12, 8, 4,gpt-3.5-turbo-Chat2
701,scammer_1819,6.3299768518518515,13, 8, 5,gpt-3.5-turbo-Chat2
702,scammer_1820,1.2302777777777778,23, 13, 10,gpt-3.5-turbo-Chat2
703,scammer_1822,1.707685185185185,13, 7, 6,gpt-4-Chat1
704,scammer_1824,3.1720486111111112,18, 10, 8,gpt-4-Chat1
705,scammer_1826,0.040949074074074075,20, 11, 9,gpt-4-Chat1
706,scammer_1828,5.072962962962963,14, 8, 6,gpt-4-Chat1
707,scammer_1831,0.040532407407407406,18, 10, 8,gpt-4-Chat1
708,scammer_1832,0.07618055555555556,5, 3, 2,gpt-4-Chat1
709,scammer_1835,5.479675925925926,12, 7, 5,gpt-4-Chat1
710,scammer_1837,0.7083796296296296,5, 3, 2,gpt-3.5-turbo-Chat2
711,scammer_1839,10.252037037037036,24, 13, 11,gpt-4-Chat1
712,scammer_1840,25.020520833333332,7, 4, 3,gpt-4-Chat1
713,scammer_1843,0.014386574074074074,3, 2, 1,gpt-3.5-turbo-Chat2
714,scammer_1845,1.1052546296296297,14, 7, 7,gpt-4-Chat1
715,scammer_1846,1.1093171296296296,15, 8, 7,gpt-4-Chat1
716,scammer_1848,3.814849537037037,7, 4, 3,gpt-3.5-turbo-Chat2
717,scammer_1850,0.45686342592592594,9, 5, 4,gpt-4-Chat1
718,scammer_1851,1.250138888888889,13, 7, 6,gpt-4-Chat1
719,scammer_1854,0.0,2, 1, 1,gpt-4-Chat1
720,scammer_1855,0.0,2, 1, 1,gpt-3.5-turbo-Chat2
721,scammer_1856,0.010439814814814815,3, 1, 2,gpt-4-Chat1
722,scammer_1857,0.04019675925925926,9, 5, 4,gpt-3.5-turbo-Chat2
723,scammer_1861,5.650891203703703,15, 8, 7,gpt-3.5-turbo-Chat2
724,scammer_1862,0.0,2, 1, 1,gpt-3.5-turbo-Chat2
725,scammer_1863,0.3775810185185185,7, 6, 1,gpt-3.5-turbo-Chat2
726,scammer_1864,0.516099537037037,11, 6, 5,gpt-3.5-turbo-Chat2
727,scammer_1865,0.03863425925925926,3, 2, 1,gpt-4-Chat1
728,scammer_1866,0.10828703703703704,9, 5, 4,gpt-4-Chat1
729,scammer_1867,0.0008101851851851852,3, 2, 1,gpt-4-Chat1
730,scammer_1877,0.03922453703703704,3, 2, 1,gpt-4-Chat1
731,scammer_1878,20.41402777777778,130, 82, 48,gpt-4-Chat1
732,scammer_1881,0.6679050925925926,5, 3, 2,gpt-3.5-turbo-Chat2
733,scammer_1883,0.11380787037037036,7, 6, 1,gpt-4-Chat1
734,scammer_1886,6.444467592592592,22, 12, 10,gpt-3.5-turbo-Chat2
735,scammer_1888,5.500532407407407,12, 7, 5,gpt-4-Chat1
736,scammer_1889,0.013726851851851851,3, 2, 1,gpt-4-Chat1
737,scammer_1893,0.9686689814814815,8, 6, 2,gpt-4-Chat1
738,scammer_1897,2.4492824074074075,18, 9, 9,gpt-3.5-turbo-Chat2
739,scammer_1900,0.0,2, 1, 1,gpt-4-Chat1
740,scammer_1904,7.2834259259259255,16, 9, 7,gpt-3.5-turbo-Chat2
741,scammer_1906,0.22828703703703704,7, 4, 3,gpt-4-Chat1
742,scammer_1909,0.04644675925925926,5, 3, 2,gpt-4-Chat1
743,scammer_1914,0.3530671296296296,23, 12, 11,gpt-4-Chat1
744,scammer_1916,0.07005787037037037,5, 3, 2,gpt-3.5-turbo-Chat2
745,scammer_1917,0.12480324074074074,9, 5, 4,gpt-3.5-turbo-Chat2
746,scammer_1918,0.03895833333333333,14, 7, 7,gpt-3.5-turbo-Chat2
747,scammer_1922,1.1459375,13, 7, 6,gpt-3.5-turbo-Chat2
748,scammer_1923,0.04708333333333333,3, 2, 1,gpt-3.5-turbo-Chat2
749,scammer_1931,5.747141203703704,7, 5, 2,gpt-4-Chat1
750,scammer_1936,1.8268402777777777,17, 11, 6,gpt-3.5-turbo-Chat2
751,scammer_1939,0.0003125,3, 2, 1,gpt-3.5-turbo-Chat2
752,scammer_1940,0.0019328703703703704,3, 2, 1,gpt-3.5-turbo-Chat2
753,scammer_1942,1.917662037037037,4, 2, 2,gpt-4-Chat1
754,scammer_1944,0.29234953703703703,11, 8, 3,gpt-3.5-turbo-Chat2
755,scammer_1947,0.014212962962962964,10, 6, 4,gpt-4-Chat1
756,scammer_1948,0.0,2, 1, 1,gpt-4-Chat1
757,scammer_1949,0.0004166666666666667,3, 2, 1,gpt-4-Chat1
758,scammer_1950,0.0002662037037037037,3, 2, 1,gpt-4-Chat1
759,scammer_1951,0.0,2, 1, 1,gpt-3.5-turbo-Chat2
760,scammer_1958,5.797939814814815,27, 14, 13,gpt-4-Chat1
761,scammer_1964,15.668993055555555,51, 27, 24,gpt-3.5-turbo-Chat2
762,scammer_1968,0.2715046296296296,13, 7, 6,gpt-3.5-turbo-Chat2
763,scammer_1972,0.007210648148148148,5, 3, 2,gpt-3.5-turbo-Chat2
764,scammer_1980,5.039016203703704,11, 7, 4,gpt-3.5-turbo-Chat2
765,scammer_1983,2.0952546296296295,21, 11, 10,gpt-3.5-turbo-Chat2
766,scammer_1985,0.022048611111111113,3, 2, 1,gpt-3.5-turbo-Chat2
767,scammer_1986,20.989016203703702,54, 32, 22,gpt-3.5-turbo-Chat2
768,scammer_1987,0.00028935185185185184,3, 2, 1,gpt-3.5-turbo-Chat2
769,scammer_1990,10.715335648148148,25, 13, 12,gpt-4-Chat1
770,scammer_1991,0.8658564814814815,14, 9, 5,gpt-4-Chat1
771,scammer_1992,0.03706018518518518,3, 2, 1,gpt-4-Chat1
772,scammer_1995,0.11972222222222222,7, 4, 3,gpt-3.5-turbo-Chat2
773,scammer_1997,0.20234953703703704,5, 3, 2,gpt-3.5-turbo-Chat2
774,scammer_1998,0.0014583333333333334,3, 2, 1,gpt-4-Chat1
775,scammer_2001,0.013414351851851853,3, 2, 1,gpt-3.5-turbo-Chat2
776,scammer_2009,0.28738425925925926,9, 5, 4,gpt-3.5-turbo-Chat2
777,scammer_2013,0.0005439814814814814,3, 2, 1,gpt-4-Chat1
778,scammer_2016,0.031689814814814816,3, 2, 1,gpt-3.5-turbo-Chat2
779,scammer_2017,0.011284722222222222,3, 2, 1,gpt-4-Chat1
780,scammer_2018,1.0285763888888888,5, 3, 2,gpt-4-Chat1
781,scammer_2020,0.01673611111111111,13, 7, 6,gpt-4-Chat1
782,scammer_2022,0.6016898148148148,9, 8, 1,gpt-3.5-turbo-Chat2
783,scammer_2023,0.15796296296296297,9, 8, 1,gpt-3.5-turbo-Chat2
784,scammer_2024,10.54474537037037,20, 10, 10,gpt-4-Chat1
785,scammer_2026,5.7290625,7, 4, 3,gpt-4-Chat1
786,scammer_2027,0.0009837962962962962,3, 2, 1,gpt-3.5-turbo-Chat2
787,scammer_2035,7.820729166666666,55, 28, 27,gpt-3.5-turbo-Chat2
788,scammer_2036,0.14895833333333333,7, 4, 3,gpt-3.5-turbo-Chat2
789,scammer_2038,3.2164699074074075,9, 5, 4,gpt-4-Chat1
790,scammer_2039,0.010636574074074074,8, 6, 2,gpt-4-Chat1
791,scammer_2054,3.323587962962963,4, 2, 2,gpt-3.5-turbo-Chat2
792,scammer_2056,0.019166666666666665,9, 5, 4,gpt-3.5-turbo-Chat2
793,scammer_2059,0.00045138888888888887,3, 2, 1,gpt-4-Chat1
794,scammer_2061,23.795752314814816,26, 15, 11,gpt-4-Chat1
795,scammer_2065,0.6249768518518518,7, 4, 3,gpt-3.5-turbo-Chat2
796,scammer_2067,0.0,2, 1, 1,gpt-4-Chat1
797,scammer_2070,1.4127546296296296,9, 7, 2,gpt-3.5-turbo-Chat2
798,scammer_2071,1.544664351851852,5, 3, 2,gpt-3.5-turbo-Chat2
799,scammer_2072,9.60869212962963,28, 15, 13,gpt-3.5-turbo-Chat2
800,scammer_2073,8.29574074074074,24, 13, 11,gpt-3.5-turbo-Chat2
801,scammer_2077,0.0010763888888888889,3, 2, 1,gpt-3.5-turbo-Chat2
802,scammer_2080,5.165729166666667,15, 8, 7,gpt-3.5-turbo-Chat2
803,scammer_2085,0.48212962962962963,13, 7, 6,gpt-4-Chat1
804,scammer_2088,0.043229166666666666,3, 2, 1,gpt-4-Chat1
805,scammer_2095,0.9773726851851852,9, 5, 4,gpt-4-Chat1
806,scammer_2098,5.2333796296296295,9, 7, 2,gpt-4-Chat1
807,scammer_2101,13.443078703703703,33, 18, 15,gpt-4-Chat1
808,scammer_2104,6.412395833333333,10, 6, 4,gpt-4-Chat1
809,scammer_2108,0.9581828703703704,36, 18, 18,gpt-3.5-turbo-Chat2
810,scammer_2111,1.3547685185185185,3, 2, 1,gpt-3.5-turbo-Chat2
811,scammer_2113,3.148622685185185,6, 5, 1,gpt-4-Chat1
812,scammer_2115,0.006863425925925926,5, 3, 2,gpt-3.5-turbo-Chat2
813,scammer_2119,0.006574074074074074,5, 3, 2,gpt-4-Chat1
814,scammer_2121,4.465034722222223,10, 6, 4,gpt-4-Chat1
815,scammer_2123,1.6781018518518518,18, 10, 8,gpt-3.5-turbo-Chat2
816,scammer_2125,3.091226851851852,16, 9, 7,gpt-3.5-turbo-Chat2
817,scammer_2131,0.015231481481481481,3, 2, 1,gpt-4-Chat1
818,scammer_2132,0.10483796296296297,19, 10, 9,gpt-3.5-turbo-Chat2
819,scammer_2135,5.380810185185185,3, 2, 1,gpt-3.5-turbo-Chat2
820,scammer_2136,2.657824074074074,23, 13, 10,gpt-4-Chat1
821,scammer_2137,0.018784722222222223,4, 2, 2,gpt-3.5-turbo-Chat2
822,scammer_2138,10.198530092592593,26, 14, 12,gpt-3.5-turbo-Chat2
823,scammer_2139,5.109837962962963,24, 13, 11,gpt-4-Chat1
824,scammer_2142,14.879131944444444,21, 11, 10,gpt-3.5-turbo-Chat2
825,scammer_2143,8.258715277777778,11, 6, 5,gpt-3.5-turbo-Chat2
826,scammer_2147,5.448206018518518,4, 3, 1,gpt-3.5-turbo-Chat2
827,scammer_2148,5.654733796296297,14, 11, 3,gpt-3.5-turbo-Chat2
828,scammer_2149,2.462013888888889,11, 8, 3,gpt-3.5-turbo-Chat2
829,scammer_2150,0.0,2, 1, 1,gpt-3.5-turbo-Chat2
830,scammer_2152,0.00829861111111111,3, 2, 1,gpt-3.5-turbo-Chat2
831,scammer_2153,3.472222222222222e-05,3, 1, 2,gpt-4-Chat1
832,scammer_2154,23.094189814814815,52, 30, 22,gpt-4-Chat1
833,scammer_2155,5.012962962962963,18, 10, 8,gpt-3.5-turbo-Chat2
834,scammer_2156,0.011122685185185185,5, 3, 2,gpt-3.5-turbo-Chat2
835,scammer_2157,7.4806944444444445,11, 7, 4,gpt-4-Chat1
836,scammer_2160,0.0,2, 1, 1,gpt-3.5-turbo-Chat2
837,scammer_2161,0.03025462962962963,13, 7, 6,gpt-4-Chat1
838,scammer_2162,0.3256134259259259,7, 6, 1,gpt-3.5-turbo-Chat2
839,scammer_2163,4.384930555555556,27, 14, 13,gpt-3.5-turbo-Chat2
840,scammer_2164,0.24887731481481482,5, 3, 2,gpt-4-Chat1
841,scammer_2165,4.524814814814815,12, 6, 6,gpt-4-Chat1
842,scammer_2172,6.002800925925926,95, 83, 12,gpt-4-Chat1
843,scammer_2173,11.465208333333333,29, 15, 14,gpt-3.5-turbo-Chat2
844,scammer_2176,3.2189699074074074,24, 13, 11,gpt-3.5-turbo-Chat2
845,scammer_2178,0.04622685185185185,3, 2, 1,gpt-4-Chat1
846,scammer_2181,9.047071759259259,16, 9, 7,gpt-4-Chat1
847,scammer_2183,11.923391203703703,29, 15, 14,gpt-4-Chat1
848,scammer_2186,4.214583333333334,23, 12, 11,gpt-3.5-turbo-Chat2
849,scammer_2188,0.024340277777777777,8, 4, 4,gpt-4-Chat1
850,scammer_2189,0.01587962962962963,3, 2, 1,gpt-4-Chat1
851,scammer_2191,6.478101851851852,36, 21, 15,gpt-4-Chat1
852,scammer_2192,0.0005092592592592592,3, 2, 1,gpt-3.5-turbo-Chat2
853,scammer_2194,0.09568287037037038,3, 1, 2,gpt-3.5-turbo-Chat2
854,scammer_2199,1.4380555555555556,3, 2, 1,gpt-4-Chat1
855,scammer_2203,17.44125,20, 14, 6,gpt-3.5-turbo-Chat2
856,scammer_2208,15.656828703703704,16, 9, 7,gpt-3.5-turbo-Chat2
857,scammer_2209,0.243125,7, 4, 3,gpt-4-Chat1
858,scammer_2210,0.2389814814814815,5, 3, 2,gpt-4-Chat1
859,scammer_2215,0.0,2, 1, 1,gpt-4-Chat1
860,scammer_2216,3.313877314814815,6, 5, 1,gpt-3.5-turbo-Chat2
861,scammer_2217,0.03363425925925926,3, 2, 1,gpt-4-Chat1
862,scammer_2219,5.361435185185186,9, 5, 4,gpt-3.5-turbo-Chat2
863,scammer_2224,0.4228240740740741,5, 3, 2,gpt-3.5-turbo-Chat2
864,scammer_2225,0.0,2, 1, 1,gpt-3.5-turbo-Chat2
865,scammer_2228,0.0,2, 1, 1,gpt-4-Chat1
866,scammer_2230,0.06707175925925926,5, 3, 2,gpt-4-Chat1
867,scammer_2233,0.06643518518518518,3, 2, 1,gpt-4-Chat1
868,scammer_2235,0.020763888888888887,3, 2, 1,gpt-3.5-turbo-Chat2
869,scammer_2236,0.0,2, 1, 1,gpt-4-Chat1
870,scammer_2237,0.0036226851851851854,3, 2, 1,gpt-4-Chat1
871,scammer_2240,0.1464236111111111,7, 4, 3,gpt-3.5-turbo-Chat2
872,scammer_2241,1.4701967592592593,3, 2, 1,gpt-4-Chat1
873,scammer_2245,0.09479166666666666,3, 2, 1,gpt-4-Chat1
874,scammer_2246,0.23520833333333332,3, 2, 1,gpt-3.5-turbo-Chat2
875,scammer_2247,0.02494212962962963,3, 2, 1,gpt-4-Chat1
876,scammer_2248,6.521446759259259,11, 6, 5,gpt-3.5-turbo-Chat2
877,scammer_2251,4.477210648148148,31, 22, 9,gpt-3.5-turbo-Chat2
878,scammer_2252,0.0005208333333333333,3, 2, 1,gpt-3.5-turbo-Chat2
879,scammer_2254,1.833425925925926,40, 20, 20,gpt-3.5-turbo-Chat2
880,scammer_2257,0.011828703703703704,3, 2, 1,gpt-3.5-turbo-Chat2
881,scammer_2259,4.221111111111111,8, 5, 3,gpt-3.5-turbo-Chat2
882,scammer_2269,0.0019444444444444444,3, 2, 1,gpt-4-Chat1
883,scammer_2270,3.054236111111111,14, 8, 6,gpt-4-Chat1
884,scammer_2271,0.0028356481481481483,7, 5, 2,gpt-4-Chat1
885,scammer_2272,0.021527777777777778,4, 2, 2,gpt-4-Chat1
886,scammer_2280,0.8661689814814815,9, 5, 4,gpt-4-Chat1
887,scammer_2281,8.039398148148148,14, 8, 6,gpt-4-Chat1
888,scammer_2285,0.0,2, 1, 1,gpt-4-Chat1
889,scammer_2287,0.0005439814814814814,3, 2, 1,gpt-4-Chat1
890,scammer_2288,5.247604166666667,16, 9, 7,gpt-3.5-turbo-Chat2
891,scammer_2291,0.00030092592592592595,3, 2, 1,gpt-4-Chat1
892,scammer_2295,0.0,2, 1, 1,gpt-4-Chat1
893,scammer_2296,0.0,2, 1, 1,gpt-4-Chat1
894,scammer_2298,0.003946759259259259,7, 4, 3,gpt-4-Chat1
895,scammer_2300,0.05357638888888889,5, 3, 2,gpt-3.5-turbo-Chat2
896,scammer_2301,0.6869791666666667,18, 12, 6,gpt-3.5-turbo-Chat2
897,scammer_2302,0.16515046296296296,8, 4, 4,gpt-3.5-turbo-Chat2
898,scammer_2303,0.9157291666666667,5, 3, 2,gpt-4-Chat1
899,scammer_2309,9.683090277777778,21, 11, 10,gpt-4-Chat1
900,scammer_2311,3.1558680555555556,63, 48, 15,gpt-4-Chat1
901,scammer_2313,0.01193287037037037,3, 2, 1,gpt-3.5-turbo-Chat2
902,scammer_2315,0.3756712962962963,3, 2, 1,gpt-3.5-turbo-Chat2
903,scammer_2316,0.12440972222222223,11, 6, 5,gpt-3.5-turbo-Chat2
904,scammer_2318,0.018344907407407407,3, 2, 1,gpt-4-Chat1
905,scammer_2319,4.605914351851852,13, 8, 5,gpt-4-Chat1
906,scammer_2321,5.082673611111111,6, 4, 2,gpt-3.5-turbo-Chat2
907,scammer_2326,0.0,2, 1, 1,gpt-4-Chat1
908,scammer_2329,10.128287037037037,17, 9, 8,gpt-3.5-turbo-Chat2
909,scammer_2333,5.8789699074074075,5, 3, 2,gpt-4-Chat1
910,scammer_2335,0.02789351851851852,10, 6, 4,gpt-4-Chat1
911,scammer_2336,3.0636342592592594,8, 5, 3,gpt-4-Chat1
912,scammer_2340,1.128252314814815,13, 7, 6,gpt-4-Chat1
913,scammer_2345,6.062303240740741,42, 23, 19,gpt-4-Chat1
914,scammer_2348,0.02193287037037037,7, 4, 3,gpt-3.5-turbo-Chat2
915,scammer_2353,9.778009259259258,22, 12, 10,gpt-4-Chat1
916,scammer_2355,1.089050925925926,3, 2, 1,gpt-4-Chat1
917,scammer_2357,3.1888194444444444,17, 9, 8,gpt-3.5-turbo-Chat2
918,scammer_2361,2.4781828703703703,7, 3, 4,gpt-4-Chat1
919,scammer_2363,0.11461805555555556,6, 3, 3,gpt-4-Chat1
920,scammer_2366,0.37482638888888886,6, 3, 3,gpt-4-Chat1
921,scammer_2368,5.227858796296296,5, 3, 2,gpt-3.5-turbo-Chat2
922,scammer_2369,0.008726851851851852,3, 1, 2,gpt-4-Chat1
923,scammer_2370,5.027465277777778,12, 7, 5,gpt-4-Chat1
924,scammer_2371,4.813148148148148,17, 9, 8,gpt-4-Chat1
925,scammer_2372,4.618032407407408,9, 5, 4,gpt-3.5-turbo-Chat2
926,scammer_2375,5.167476851851852,22, 14, 8,gpt-4-Chat1
927,scammer_2379,0.0,2, 1, 1,gpt-4-Chat1
928,scammer_2385,4.8756712962962965,3, 2, 1,gpt-3.5-turbo-Chat2
929,scammer_2389,0.0,2, 1, 1,gpt-4-Chat1
930,scammer_2392,4.41837962962963,21, 14, 7,gpt-4-Chat1
931,scammer_2394,0.00020833333333333335,3, 2, 1,gpt-3.5-turbo-Chat2
932,scammer_2395,5.414050925925926,23, 12, 11,gpt-4-Chat1
933,scammer_2398,18.414513888888887,14, 10, 4,gpt-3.5-turbo-Chat2
934,scammer_2400,0.7833217592592593,10, 6, 4,gpt-4-Chat1
935,scammer_2401,0.00030092592592592595,3, 2, 1,gpt-3.5-turbo-Chat2
936,scammer_2406,8.765949074074074,44, 23, 21,gpt-3.5-turbo-Chat2
937,scammer_2407,0.9592361111111111,29, 18, 11,gpt-4-Chat1
938,scammer_2408,2.0693055555555557,8, 5, 3,gpt-3.5-turbo-Chat2
939,scammer_2409,0.0,2, 1, 1,gpt-3.5-turbo-Chat2
940,scammer_2411,28.507638888888888,73, 39, 34,gpt-3.5-turbo-Chat2
941,scammer_2412,6.250092592592592,18, 10, 8,gpt-4-Chat1
942,scammer_2413,9.616724537037037,140, 71, 69,gpt-4-Chat1
943,scammer_2417,3.1119328703703704,11, 8, 3,gpt-4-Chat1
944,scammer_2421,0.04383101851851852,7, 4, 3,gpt-4-Chat1
945,scammer_2422,3.217361111111111,3, 2, 1,gpt-3.5-turbo-Chat2
946,scammer_2423,0.0,2, 1, 1,gpt-3.5-turbo-Chat2
947,scammer_2426,0.0,2, 1, 1,gpt-3.5-turbo-Chat2
948,scammer_2432,0.465162037037037,7, 4, 3,gpt-4-Chat1
949,scammer_2433,31.31857638888889,130, 72, 58,gpt-4-Chat1
950,scammer_2435,0.01638888888888889,3, 2, 1,gpt-4-Chat1
951,scammer_2441,0.019224537037037037,3, 2, 1,gpt-4-Chat1
952,scammer_2443,22.151666666666667,9, 5, 4,gpt-4-Chat1
953,scammer_2447,1.0879166666666666,14, 8, 6,gpt-4-Chat1
954,scammer_2451,13.076921296296296,5, 3, 2,gpt-3.5-turbo-Chat2
955,scammer_2453,0.8915046296296296,17, 9, 8,gpt-4-Chat1
956,scammer_2454,4.063773148148148,4, 3, 1,gpt-4-Chat1
957,scammer_2455,3.0615625,9, 5, 4,gpt-3.5-turbo-Chat2
958,scammer_2457,0.006539351851851852,3, 2, 1,gpt-3.5-turbo-Chat2
959,scammer_2463,14.374351851851852,19, 10, 9,gpt-4-Chat1
960,scammer_2467,0.624849537037037,10, 5, 5,gpt-4-Chat1
961,scammer_2472,0.021423611111111112,11, 7, 4,gpt-4-Chat1
962,scammer_2478,5.355567129629629,40, 24, 16,gpt-4-Chat1
963,scammer_2480,5.074675925925926,5, 3, 2,gpt-4-Chat1
964,scammer_2485,7.838333333333333,39, 27, 12,gpt-4-Chat1
965,scammer_2487,0.03753472222222222,3, 2, 1,gpt-4-Chat1
966,scammer_2495,3.646574074074074,12, 6, 6,gpt-4-Chat1
967,scammer_2497,0.0,2, 1, 1,gpt-3.5-turbo-Chat2
968,scammer_2500,0.028796296296296296,5, 3, 2,gpt-4-Chat1
969,scammer_2501,3.7055902777777776,5, 3, 2,gpt-3.5-turbo-Chat2
970,scammer_2505,17.71074074074074,82, 46, 36,gpt-3.5-turbo-Chat2
971,scammer_2509,1.1682523148148147,72, 60, 12,gpt-3.5-turbo-Chat2
972,scammer_2510,4.74494212962963,5, 3, 2,gpt-4-Chat1
973,scammer_2511,1.1552777777777778,11, 7, 4,gpt-3.5-turbo-Chat2
974,scammer_2513,17.252743055555555,12, 6, 6,gpt-4-Chat1
975,scammer_2514,0.02519675925925926,29, 15, 14,gpt-3.5-turbo-Chat2
976,scammer_2520,5.3965625,8, 6, 2,gpt-3.5-turbo-Chat2
977,scammer_2526,5.099918981481482,12, 6, 6,gpt-3.5-turbo-Chat2
978,scammer_2528,7.982291666666667,8, 5, 3,gpt-3.5-turbo-Chat2
979,scammer_2531,2.296736111111111,10, 8, 2,gpt-4-Chat1
980,scammer_2536,7.12837962962963,15, 9, 6,gpt-4-Chat1
981,scammer_2538,4.6635532407407405,13, 11, 2,gpt-4-Chat1
982,scammer_2540,14.621180555555556,11, 7, 4,gpt-3.5-turbo-Chat2
983,scammer_2541,0.018819444444444444,3, 2, 1,gpt-3.5-turbo-Chat2
984,scammer_2542,3.189189814814815,8, 5, 3,gpt-3.5-turbo-Chat2
985,scammer_2544,0.08306712962962963,6, 3, 3,gpt-3.5-turbo-Chat2
986,scammer_2546,0.0433912037037037,3, 1, 2,gpt-3.5-turbo-Chat2
987,scammer_2553,0.06108796296296296,3, 2, 1,gpt-4-Chat1
988,scammer_2554,0.02771990740740741,3, 2, 1,gpt-3.5-turbo-Chat2
989,scammer_2560,0.0008912037037037037,3, 2, 1,gpt-4-Chat1
990,scammer_2561,5.793101851851852,9, 5, 4,gpt-3.5-turbo-Chat2
991,scammer_2562,0.03457175925925926,3, 2, 1,gpt-3.5-turbo-Chat2
992,scammer_2566,0.9585763888888889,32, 19, 13,gpt-4-Chat1
993,scammer_2567,0.0002199074074074074,3, 2, 1,gpt-4-Chat1
994,scammer_2570,0.1671412037037037,18, 15, 3,gpt-3.5-turbo-Chat2
995,scammer_2571,4.104606481481482,13, 8, 5,gpt-4-Chat1
996,scammer_2574,1.3078935185185185,26, 13, 13,gpt-4-Chat1
997,scammer_2575,0.08234953703703704,5, 3, 2,gpt-4-Chat1
998,scammer_2576,0.3033101851851852,9, 5, 4,gpt-3.5-turbo-Chat2
999,scammer_2579,2.9528935185185183,5, 3, 2,gpt-3.5-turbo-Chat2
1000,scammer_2580,3.0092708333333333,8, 5, 3,gpt-4-Chat1
1001,scammer_2583,5.81494212962963,17, 9, 8,gpt-3.5-turbo-Chat2
1002,scammer_2587,0.29324074074074075,6, 5, 1,gpt-3.5-turbo-Chat2
1003,scammer_2588,0.9381597222222222,21, 12, 9,gpt-4-Chat1
1004,scammer_2589,0.025671296296296296,7, 4, 3,gpt-3.5-turbo-Chat2
1005,scammer_2596,10.677280092592593,73, 40, 33,gpt-3.5-turbo-Chat2
1006,scammer_2599,0.0,2, 1, 1,gpt-4-Chat1
1007,scammer_2602,5.308738425925926,19, 10, 9,gpt-3.5-turbo-Chat2
1008,scammer_2605,4.061168981481481,5, 3, 2,gpt-3.5-turbo-Chat2
1009,scammer_2606,0.02962962962962963,9, 5, 4,gpt-4-Chat1
1010,scammer_2607,0.020243055555555556,5, 3, 2,gpt-4-Chat1
1011,scammer_2608,1.1993518518518518,119, 91, 28,gpt-3.5-turbo-Chat2
1012,scammer_2611,0.608738425925926,5, 3, 2,gpt-4-Chat1
1013,scammer_2618,0.40221064814814816,8, 4, 4,gpt-3.5-turbo-Chat2
1014,scammer_2620,7.094270833333334,25, 15, 10,gpt-4-Chat1
1015,scammer_2622,0.7230324074074074,3, 2, 1,gpt-4-Chat1
1016,scammer_2624,2.251423611111111,5, 3, 2,gpt-4-Chat1
1017,scammer_2625,9.848842592592593,51, 31, 20,gpt-4-Chat1
1018,scammer_2627,1.0599537037037037,9, 5, 4,gpt-4-Chat1
1019,scammer_2628,0.3749884259259259,3, 2, 1,gpt-3.5-turbo-Chat2
1020,scammer_2629,0.0,2, 1, 1,gpt-3.5-turbo-Chat2
1021,scammer_2632,0.05717592592592593,13, 7, 6,gpt-4-Chat1
1022,scammer_2634,3.855625,13, 7, 6,gpt-3.5-turbo-Chat2
1023,scammer_2636,0.19944444444444445,13, 7, 6,gpt-4-Chat1
1024,scammer_2638,2.513217592592593,58, 33, 25,gpt-3.5-turbo-Chat2
1025,scammer_2640,0.05668981481481482,7, 4, 3,gpt-4-Chat1
1026,scammer_2641,0.539212962962963,5, 3, 2,gpt-4-Chat1
1027,scammer_2642,14.924768518518519,41, 22, 19,gpt-3.5-turbo-Chat2
1028,scammer_2643,5.16681712962963,15, 10, 5,gpt-4-Chat1
1029,scammer_2645,9.335347222222222,11, 6, 5,gpt-3.5-turbo-Chat2
1030,scammer_2647,7.990925925925926,33, 18, 15,gpt-4-Chat1
1031,scammer_2649,0.04386574074074074,7, 4, 3,gpt-3.5-turbo-Chat2
1032,scammer_2650,5.948761574074074,3, 2, 1,gpt-4-Chat1
1033,scammer_2659,0.20805555555555555,6, 3, 3,gpt-4-Chat1
1034,scammer_2661,0.15001157407407406,3, 2, 1,gpt-4-Chat1
1035,scammer_2662,0.0,2, 1, 1,gpt-4-Chat1
1036,scammer_2663,3.5936574074074072,4, 3, 1,gpt-4-Chat1
1037,scammer_2664,0.0,2, 1, 1,gpt-4-Chat1
1038,scammer_2665,23.111203703703705,25, 18, 7,gpt-4-Chat1
1039,scammer_2666,20.836064814814815,12, 9, 3,gpt-3.5-turbo-Chat2
1040,scammer_2669,0.0022569444444444442,5, 4, 1,gpt-4-Chat1
1041,scammer_2674,0.08474537037037037,56, 27, 29,gpt-3.5-turbo-Chat2
1042,scammer_2676,3.688298611111111,16, 9, 7,gpt-4-Chat1
1043,scammer_2678,0.0016782407407407408,4, 3, 1,gpt-4-Chat1
1044,scammer_2680,1.7049074074074073,21, 13, 8,gpt-3.5-turbo-Chat2
1045,scammer_2681,3.1242824074074074,11, 7, 4,gpt-4-Chat1
1046,scammer_2682,0.0,2, 1, 1,gpt-3.5-turbo-Chat2
1047,scammer_2685,6.031041666666667,40, 25, 15,gpt-4-Chat1
1048,scammer_2687,2.7105439814814813,6, 2, 4,gpt-4-Chat1
1049,scammer_2691,5.994513888888889,9, 5, 4,gpt-4-Chat1
1050,scammer_2692,0.7102546296296296,9, 5, 4,gpt-4-Chat1
1051,scammer_2696,0.15342592592592594,5, 3, 2,gpt-3.5-turbo-Chat2
1052,scammer_2697,0.004675925925925926,5, 3, 2,gpt-4-Chat1
1053,scammer_2700,10.396747685185185,16, 9, 7,gpt-4-Chat1
1054,scammer_2703,1.0824652777777777,5, 3, 2,gpt-4-Chat1
1055,scammer_2706,0.0021180555555555558,5, 4, 1,gpt-4-Chat1
